%s ago=%s тому назад
%s used of %s %s %%=%s используется из %s (%s %%)
---=
10 s=10 c
30 s=30 c
1 m=1 м
2 m=2 м
Active tunnels=Активные туннели
Activity=Активность
ago=тому назад
Airflow=Воздушный поток
All Apps=Все приложения
All VMs=Все ВМ
Battery charge=Заряд батареи
BIOS dated=BIOS датирован
Click to toggle CPU chart=
Click to toggle details=Нажмите, чтобы переключить детали
Completed=Завершенный
Counters info=Информация о счётчиках
Current operation %s on %s=Текущая операция %s на **%s**
custom image=изображение пользователя
Data is invalid=Данные недействительны
default image=изображение п умолчанию
Docker Containers=
Due in=
Elapsed time=Прошедшее время
Errors info=Информация об ошибках
Estimated finish=
failed device=вышедшее из строя устройство
Fan count=
FAN=
Finding %s error=Finding: **%s** error
Finding %s errors=Finding: **%s** errors
General info=Общая информация
Go to cache settings=Перейти к настройкам кеша
Go to CPU pinning settings=
Go to disk settings=Перейти к настройкам диска
Go to Docker settings=
Go to fan settings=Перейти к настройкам вентилятора
Go to identification settings=Перейти к настройкам идентификации
Go to network settings=Перейти к настройкам сети
Go to scheduler settings=Перейти к настройкам планировщика
Go to Share settings=
Go to UPS settings=Перейти к настройкам ИБП
Go to User settings=Перейти к настройкам пользователей
Go to VM settings=Перейти к настройкам ВМ
Go to VPN settings=Перейти к настройкам VPN
Handshake=
has=имеет
healthy=
heat warning=
Hide details=Скрыть детали
in progress=
Inactive tunnels=
inactive=неактивный
Inbound=
invalid device=недопустимое устройство
invalid devices=недопустимые устройства
Last check completed on %s=Последняя проверка завершена **%s**
Last check incomplete on %s=Последняя проверка не завершена **%s**
Last checked on %s=Последний раз проверено **%s**
Maximum size=Максимальный размер
Mode of operation=Режим работы
Network traffic=Сетевой трафик
Next check scheduled on %s=Следующая проверка запланирована на **%s**
No docker containers defined=
No running docker containers=
No running virtual machines=Нет запущенных виртуальных машин
No shares present=
No virtual machines defined=Виртуальные машины не определены
Nominal power=
not received=
Only PNG images are allowed=Only PNG images are allowed!
Outbound=
Overall Load=Общая нагрузка
Parity disk not present=Диск чётности отсутствует
Parity disks not present=Диски чётности отсутствуют
Parity has not been checked yet=Чётность ещё не проверена
Parity is degraded=Чётность ухудшена
Power=
Put system to sleep=Перевести систему в спящий режим
Reboot the system=Перезагрузить систему
Receive counters=Счетчики получения
Received packets=Полученные пакеты
Runtime left=
Scheduled parity check is disabled=Запланированная проверка чётности отключена
Select Case Model=Выберите модель корпуса
Select time frame=
Share count %s with %s cache only and %s encrypted=Share count: %s with %s cache only and %s encrypted
Show details=Показать детали
Show Information=Показать информацию
Shutdown the system=Завершить работу системы
SMART error=Ошибка SMART
SMART health-check failed=
SMART=
sn=с/н
Start the array=Запустить массив
Started only=Только запущенные
Stop the array=Остановить массив
Temp=Температура
This will put the system to sleep=Это переведет систему в спящий режим
This will reboot the system=Это перезагрузит систему
This will shutdown the system=Это приведёт к завершению работы системы
This will start the array=Это запустит массив
This will stop the array=Это остановит массив
Transmit counters=Счётчики передачи
Transmitted packets=Переданные пакеты
UPS Load=Нагрузка ИБП
UPS status=Статус ИБП
Usable size=Используемый размер
User count %s with %s unprotected=User count: %s with %s unprotected
utilization warning=
View Running Processes=Просмотр запущенных процессов
Virtual Machines=Виртуальные машины
