also remove image=также удалить образ
Apply=Применить
Are you sure=Вы уверены?
Cancel=Отмена
checking=проверка
Completely REMOVE=Полностью УДАЛИТЬ
Console=Консоль
day=день
days=дней
disk image and definition=образ диска и определение
Disks=Диски
Done=Готово
Edit=Изменить
Execution error=Ошибка выполнения
Force Stop=Принудительная остановка
Hibernate=Спящий режим
Log for=Журнал для:
log=Журнал
Logs=Журналы
More Info=Больше информации
No=Нет
OK=ОК
Ok=Ок
Pause=Приостановить
Proceed=Продолжить
Project Page=Страница проекта
Remove container=Удалить контейнер
Remove definition=Удалить определение
Remove image=Удалить образ
Remove VM=Удалить ВМ
Remove=Удалить
Restart=Перезапустить
Resume=Возобновить
Start=Запустить
Stop=Остановить
Support=Служба поддержки
Update container=Обновить контейнер
Update=Обновить
Updating all Containers=Обновление всех контейнеров
Updating the container=Обновление контейнера
VNC Remote=Удалённый доступ VNC
WebUI=Веб-интерфейс
Yes, delete it=Да, удалить!
Yes, update it=Да, обновить!
Yes=Да

; footer messages
Array Starting=Запуск массива
Array Stopping=Остановка массива
Mounting disks=
Spinning up all drives=
Starting services=Запуск сервисов
Stopping services=Остановка сервисов
Unmounting disks=
Autostart disabled=Автозапуск отключен
Missing encryption key=Отсутствует ключ шифрования
Opening encrypted volumes=Открытие зашифрованных томов

; docker variables
Container Path=Путь к контейнеру
Container Port=Порт контейнера
Container Variable=Переменная контейнера
Container Label=Этикетка контейнера
Container Device=Устройство контейнера
