%s An update is available=%s: доступно обновление.
anonymous=анонимный
Author=Автор
Check For Updates=Проверить наличие обновлений
Checking connectivty=Проверка подключения
checking=проверка
Click here to install version %s=Нажмите здесь, чтобы установить версию %s
Delete Plugin=Удалить плагин
DOWNGRADE TO VERSION=ПЕРЕХОД НА ВЕРСИЮ
Enter URL of remote plugin file or local plugin file=Введите URL-адрес удаленного файла плагина или локального файла плагина
ERROR=ОШИБКА
Install Plugin=Установить плагин
Install=Установить
install=установить
Installed Plugins=Установленные плагины
Installing Update=Устанавливается обновление
need check=нужна проверка
Next=Дальше
No plugins installed=Плагины не установлены
No release notes available=Нет доступных примечаний к выпуску
No response, aborting=
Plugin File=Файл плагина
Plugin File Install Errors=Ошибки при установке файла плагина
Plugin History=История плагина
Plugin Update Check=Проверка обновлений плагина
Plugin=Плагин
Release Notes=Примечания к выпуску
Remove Plugin=Удалить плагин
remove=Удалить
Select local plugin file=Выберите локальный файл плагина
Stable=Стабильный
STALE=ПРОСТОЙ
Support Thread=Тема на форуме
Uninstall=Удалить
Update All Plugins=Обновить все плагины
Update Plugin=Обновить плагин
Upgrade=Обновить
View Release Notes=Просмотреть примечания к выпуску
