20 EHCI=2.0 (EHCI)
30 nec XHCI=3.0 (nec XHCI)
30 qemu XHCI=3.0 (qemu XHCI)
Allocation=Распределение
and if using graphics device passthrough it too needs UEFI=и если используется сквозное графическое устройство, ему тоже нужен UEFI
Are you sure=Вы уверены
Array must be started to view Virtual Machines=Массив должен быть **запущен** для просмотра виртуальных машин
Autostart=Автозапуск
Back=Назад
Bus=Шина
Capacity=Емкость
Change Icon=Изменить значок
Cleanup=Очистка
Click and Select cdrom image to install operating system=Нажмите и выберите образ CD, чтобы установить ОС.
Config Folder=Папка конфигурации
Copy Paste Domain XML Configuration Here=Скопируйте и вставьте сюда конфигурацию XML домена
CPU Mode=Режим ЦП
CPUs=Процессоры
Create=Создать
Creating=Создание
define the amount memory=определение объема оперативной памяти
define the maximum amount of memory=определение максимального объема оперативной памяти
define type of cpu presented to this vm=определение типа процессора, представленного этой ВМ
description of virtual machine=описание виртуальной машины
Disk devices=Дисковые устройства
Download Folder=Папка для скачивания
Download, Click and Select virtio drivers image=Загрузите, нажмите и выберите образ драйверов virtio
Downloading=Скачивание
eg=например
Emulated=Эмуляция
Extracting=Извлечение
Folder to save the LibreELEC image to=
Folder to save the OpenELEC image to=
Form View=Просмотр формы
free=
Graphics Card=Видеокарта
Graphics ROM BIOS=
Graphics=Графика
Host Passthrough=
Hyperv tweaks for Windows=Твики Hyperv для Windows
Hyper-V=
i440fx will work for most=i440fx будет работать для большинства
Icon=Иконка
Initial=Исходная
Invalid VM to edit=
ISO storage path doesnt exist=Путь к хранилищу ISO не существует
ISO storage path was empty=Путь к хранилищу ISO пуст
keyboard for VNC=клавиатура для VNC
LibreELEC Version=Версия LibreELEC
LibreELEC=
Libvirt Service failed to start=Не удалось запустить службу Libvirt
Logical CPUs=Логические процессоры
Machine=Машина
Manual=Выбрать
Max=Максимальная
MD5 verification failed, your download is incomplete or corrupted=Ошибка проверки MD5, загрузка неполная или повреждена
mount tag inside vm=
My Workstation=Моя рабочая станция
name of mount tag inside vm=имя тега монтирования внутри вм
Name of virtual machine=Имя виртуальной машины
Network Bridge=Сетевой мост
Network MAC=Сетевой MAC
Network Model=Модель сети
No Virtual Machines installed=Виртуальные машины не установлены
None available=Нет в наличии
Not enough free space, need at least=Недостаточно свободного места, нужно как минимум
Not running=Не запущен
OpenELEC Version=Версия OpenELEC
OpenELEC=
OS Install CDRom Bus=
OS Install ISO=
Other PCI Devices=Другие устройства PCI
OVMF requires a UEFI-compatable OS=OVMF требует UEFI-совместимой ОС
OVMF=
password for VNC=пароль для VNC
path of Unraid share=путь к общему ресурсу Unraid
path on Unraid share to save LibreELEC settings=путь к общему ресурсу Unraid для сохранения настроек LibreELEC
path on Unraid share to save OpenELEC settings=путь к общему ресурсу Unraid для сохранения настроек OpenELEC
Path to ROM BIOS file=Путь к файлу ROM BIOS
Please choose a folder the LibreELEC image will download to=Выберите папку, в которую будет загружен образ LibreELEC
Please choose a folder the OpenELEC image will download to=Выберите папку, в которую будет загружен образ OpenELEC
Primary=Первичный
Q35 for a newer machine model with PCIE=Q35 для новой модели машины с PCIE
QEMU64=
random mac, you can supply your own=случайный MAC-адрес, вы можете поставить свой собственный
re-generate random mac address=повторно сгенерировать случайный MAC-адрес
Remove LibreELEC image=Удалить образ LibreELEC
Remove OpenELEC image=Удалить образ OpenELEC
Remove this LibreELEC file=Удалить этот файл LibreELEC
Remove this OpenELEC file=Удалить этот файл OpenELEC
SeaBIOS will work for most=SeaBIOS будет работать для большинства
SeaBIOS=
Select the BIOS=Выберите BIOS
Select the LibreELEC version to use=Выберите версию LibreELEC для использования
Select the machine model=Выберите модель машины
Select the OpenELEC version to use=Выберите версию OpenELEC для использования
Select the USB Controller to emulate=Выберите USB-контроллер для эмуляции
Separate sub-folder and image will be created based on Name=Отдельная подпапка и образ будут созданы на основе имени
shares=
Some OSes wont support USB3=Некоторые ОС не поддерживают USB3
Sound Card=Звуковая карта
Start All=Запусь всё
Start VM after creation=Запустить виртуальную машину после создания
Stop All=Остановить всё
Toggle VM autostart=Переключить автозапуск ВМ
type of storage image=тип хранилища образа
Unknown action=Неизвестное действие
Unknown version=Неизвестная версия
Unraid Mount tag=
Unraid Share=
Updating=Обновление
USB Controller=USB-контроллер
USB Devices=USB-устройства
vDisk Bus=Шина vDisk
vDisk Location=Расположение vDisk
vDisk Size=Размер vDisk
vDisk Type=Тип vDisk
vDisks=
video for VNC=видео для VNC
VirtIO Drivers CDRom Bus=
VirtIO Drivers ISO=
Virtual Machines=Виртуальные машины
VM creation error=Ошибка создания ВМ
VM image deletion error=Ошибка удаления образа ВМ
VNC Keyboard=Клавиатура VNC
VNC Password=Пароль VNC
VNC Video Driver=Видеодрайвер VNC
VNC=
Wasnt able to stop the process=Не удалось остановить процесс
Windows 7XP=Windows 7/XP
Windows 82012, newer Linux distros=Windows 8/2012, более новые дистрибутивы Linux
XML View=Просмотр XML
