Automatic theming=ваыпап
Bing API key=ывапывап
Bing=вапывап
City name=ывапывап
Country name=ывапыва
Day theme=ывапыарыв
Geocoding service=паоап
Google API key=паорап
Google=апропро
MapQuest API key=проапо
MapQuest=пароп
Night theme=аппар
No geographical coordinates found for the given address=апр
Please adjust=про
Postal code=апоапро
See=апроапр
Street address=апоа
this site=апапо
to obtain a Bing API key=апрапр
to obtain a Google API key=ап
to obtain a MapQuest API key=паро

:day_night_plug:
> Enter your address information (street, city, country) which is used to calculate the sunrise and sunset times of your location.
>
> A geocoding service is used to convert your address to geographical (latitude and longitude) coordinates.<br>
> You need to register with one of the available services and get a unique API key to make use of their service.
>
> The **day** theme is selected between sunrise and sunset<br>
> The **night** theme is selected between sunset and sunrise
:end
